 -----------------------------------------------------
|                                                    |
|                                                    |
|                                                    |
|                                                    |
|                                                    |
|                                                    |
|                                                    |
|                                                    |
|             -----------                            |
|             |         |                            |
|             |         |                            |
|                       |                            |
|             |         |                            |
|             |         |                            |
|             -----------                            |
|                                                    |
|                                                    |
|                                                    |
|                                                    |
|                                                    |
|                                                    |
|                                                    |
|                                                    |
|                                                    |
|                                                    |
------------------------------------------------------