+++++++++++++++++++++++++++++++++++++++++++++++++++++++++++++++++++++++++++++++++++++++++++++++++++++++++++++++++++++++++++++++++++++++++++++++++++++++++++++++++++++++++++++++++++++++++++++++++++++++++++++++++++++++++++++++++++++++++++++
+                                                                                                                                                                                                                                           +
+                                                                                                                                                                                                                                           +
+                                                                                                                                                                                                                                           +
+                                                                                                                                                                                                                                           +
+                                                                                                                                                                                                                                           +
+                                                                                                                                                                                                                                           +
+                                                                                                                                                                                                                                           +
+                                                                                                                                                                                                                                           +
+                                                                                                                                                                                                                                           +
+                                                                                                                                                                                                                                           +
+                                                                                                                                                                                                                                           +
+                                                                                                                                                                                                                                           +
+                                                                                                                                                                                                                                           +
+                                                                                                                                                                                                                                           +
+                                                                                                                                                                                                                                           +
+                                                                                                                                                                                                                                           +
+                                                                                                                                                                                                                                           +
+                                                                                                                                                                                                                                           +
+                                                                                                                                                                                                                                           +
+                                                                                                                                                                                                                                           +
+                                                                                                                                                                                                                                           +
+                                                                                                                                                                                                                                           +
+                                                                                  ___                       __      ____         _  __ _  __                                                                                               +
+                                                                                 /   |   ____ ___   ____   / /__   / __ \ _____ (_)/ /(_)/ /_ ___                                                                                          +
+                                                                                / /| |  / __ `__ \ / __ \ / //_/  / / / // ___// // // // __// _ \                                                                                         +
+                                                                               / ___ | / / / / / // /_/ // ,<    / /_/ // /__ / // // // /_ /  __/                                                                                         +
+                                                     ___             __       /_/  |_|/_/ /_/ /_/ \________|_|   \____/ \___//_//_//_/ \__/ \___/              _                                                                           +
+                                                    /   |     _____ / /_ ____   _____ __  __   ____   / __/  ____  _   __ ___   _____ _____ ____   ____ ___   (_)____   ____ _                                                             +
+                                                   / /| |    / ___// __// __ \ / ___// / / /  / __ \ / /_   / __ \| | / // _ \ / ___// ___// __ \ / __ `__ \ / // __ \ / __ `/                                                             +
+                                                  / ___ |   (__  )/ /_ / /_/ // /   / /_/ /  / /_/ // __/  / /_/ /| |/ //  __// /   / /__ / /_/ // / / / / // // / / // /_/ /                                                              +
+                                                 /_/  |_|  /____/ \__/ \____//_/    \__, /   \____//_/     \____/ |___/ \___//_/    \___/ \____//_/ /_/ /_//_//_/ /_/ \__, /                                                               +
+                                                                                   /____/                                                                            /____/                                                                +
+                                                                                                                                                                                                                                           +
+                                                                                                                                                                                                                                           +
+                                                                                                                                                                                                                                           +
+                                                                                                                                                                                                                                           +
+                                                                                                                                                                                                                                           +
+                                                                                                                                                                                                                                           +
+                                                                                                                                                                                                                                           +
+                                                                                                                                                                                                                                           +
+                                                                                                                                                                                                                                           +
+                                                                                                                                                                                                                                           +
+                                                                                                                                                                                                                                           +
+                                                                                                                                                                                                                                           +
+                                                                                                                                                                                                                                           +
+                                                                                                                                                                                                                                           +
+                                                                                                                                                                                                                                           +
+                                                                                                                                                                                                                                           +
+                                                                                                                                                                                                                                           +
+                                                                                                                                                                                                                                           +
+                                                                                                                                                                                                                                           +
+                                                                                                                                                                                                                                           +
+                                                                                                                                                                                                                                           +
+                                                                                                                                                                                                                                           +
+                                                                                                                                                                                                                                           +
+                                                                                                                                                                                                                                           +
+                                                                                                                                                                                                                                           +
+                                                                                                                                                                                                                                           +
+                                                                                                                                                                                                                                           +
+                                                                                                                                                                                                                                           +
+                                                                                                                                                                                                                                           +
+                                                                                                                                                                                                                                           +
+                                                                                                                                                                                                                                           +
+++++++++++++++++++++++++++++++++++++++++++++++++++++++++++++++++++++++++++++++++++++++++++++++++++++++++++++++++++++++++++++++++++++++++++++++++++++++++++++++++++++++++++++++++++++++++++++++++++++++++++++++++++++++++++++++++++++++++++++