+++++++++++++++++++++++++++++++++++++++++++++++++++++++++++++++++++++++++++++++++++++++++++++++++++++++++++++++++++++++++++++++++++++++++++++++++++++++++++++++++++++++++++++++++++++++++++++++++++++++++++++
+                                                                                                                                                                                                           +
+                                                                                                                                                                                                           +
+                                                                                                                                                                                                           +
+                                                                                                                                                                                                           +
+                                                                                                                                                                                                           +
+                                                                                                                                                                                                           +
+                                                                                                                                                                                                           +
+++++++++++++++++++++++++++++++++++++++++++++++++++++++++++++++++++++++++++++++++++++++++++++++++++++++++++++++++++++++++++++++++++++++++++++++++++++++++++++++++++++++++++++++++++++++++++                 +
+                                                                                                                                                                                         +                 +
+                                                                                                                                                                                         +                 +
+                                                                                                                                                                                         +                 +
+                                                                                                                                                                                         +                 +
+++++++++++++++++++++++++++++++++++++++++++++++++++++++++++++++++++++++++++++++++++++++++++++++++++++++++++++++++++++++++++++++++++++++++++++++++++++++++++++++++++++++++++++++++++++++++++                 +
+                                                                                                                                                                                                           +
+                                                                                                                                                                                                           +
+                                                                                                                                                                                                           +
+                                                                                                                                                                                                           +
+                                                                                                                                                                                                           +
+                                                                                                                                                                                                           +
+                 +++++++++++++++++++++++++++++++++++++++++++++++++++++++++++++++++++++++++++++++++++++++++++++++++++++++++++++++++++++++++++++++++++++++++++++++++++++++++++++++++++++++++++++++++++++++++++
+                 +                                                                                                                                                                                         +
+                 +                                                                                                                                                                                         +
+                 +                                                                                                                                                                                         +
+                 +                                                                                                                                                                                         +
+                 +++++++++++++++++++++++++++++++++++++++++++++++++++++++++++++++++++++++++++++++++++++++++++++++++++++++++++++++++++++++++++++++++++++++++++++++++++++++++++++++++++++++++++++++++++++++++++
+                                                                                                                                                                                                           +
+                                                                                                                                                                                                           +
+                                                                                                                                                                                                           +
+                                                                                                                                                                                                           +
+                                                                                                                                                                                                           +
+                                                                                                                                                                                                           +
++++++++++++++++++++++++++++++++++++++++++++++++++++++++++++++++++++++++++++++++++++++++++++++++++++++++++++++++++++++++++++++++++++++++++++++++++++++++++++++++++++++++++++++++++++++++++                  +
+                                                                                                                                                                                        +                  +
+                                                                                                                                                                                        +                  +
+                                                                                                                                                                                        +                  +
+                                                                                                                                                                                        +                  +
++++++++++++++++++++++++++++++++++++++++++++++++++++++++++++++++++++++++++++++++++++++++++++++++++++++++++++++++++++++++++++++++++++++++++++++++++++++++++++++++++++++++++++++++++++++++++                  +
+                                                                                                                                                                                                           +
+                                                                                                                                                                                                           +
+                                                                                                                                                                                                           +
+                                                                                                                                                                                                           +
+                                                                                                                                                                                                           +
+                                                                                                                                                                                                           +
+                                                                                                                                                                                                           +
+                  ++++++++++++++++++++++++++++++++++++++++++++++++++++++++++++++++++++++++++++++++++++++++++++++++++++++++++++++++++++++++++++++++++++++++++++++++++++++++++++++++++++++++++++++++++++++++++
+                                                                                                                                                                                                           +
+                                                                                                                                                                                             ##  ##  ##  ##+
+                                                                                                                                                                                           ##  ##  ##  ##  +
+                                                                                                                                                                                             ##  ##  ##  ##+
+                                                                                                                                                                                           ##  ##  ##  ##  +
+                                                                                                                                                                                             ##  ##  ##  ##+
+                                                                                                                                                                                           ##  ##  ##  ##  +
+                                                                                                                                                                                             ##  ##  ##  ##+
+++++++++++++++++++++++++++++++++++++++++++++++++++++++++++++++++++++++++++++++++++++++++++++++++++++++++++++++++++++++++++++++++++++++++++++++++++++++++++++++++++++++++++++++++++++++++++++++++++++++++++++