+++++++++++++++++++++++++++++++++++++++++++++++++++++++++++++++++++++++++++++++++++++++++++++++++++++++++++++++++++++++++++++++++++++++++++++++++++++++++++++++++++++++++++++++++++++++++++++++++++++++++++++
+                                    +                                                                                                                                                                      +
+                                    +                                                                                                                                                                      +
+                                    +                                                                                                                                                                      +
+                                    +                                                                                                                                                                      +
+                                    +                                                                                                                                                                      +
+                                    +                                                                                                                                                                      +
+                                    +                                                                                                                                                                      +
++++++++++++++++++                   ++++++++++++++++++++++++++++++++++++++++++++++++++++++++++++++++++++++++++++++++++++++++++++++++++++++++++++++++++++++++++++++++++++++++++++++++++++++++++++++++++++++++
+                +                                                                                                                                                                                          +
+                +                                                                                                                                                                                          +
+                +                                                                                                                                                                                          +
+                +                                                                                                                                                                                          +
+                +                                                                                                                                                                                          +
+                +                                                                                                                                                                                          +
+                +                                                                                                                                                                                          +
+                +                                                                                                                                                                                          +
+                +                                                                                                                                                                                          +
+                +                                                                                                                                                                                          +
+                +                                                                                                                                                                                          +
+                +                                                                                                                                                                                          +
+                +                                                                                                                                                                                          +
+                +                                                                                                                                                                                          +
+                +                                                                                                                                                                                          +
+                +                                                                                                                                                                                          +
+                +                                                                                                                                                                                          +
+                +                                                                                                                                                                                          +
+                +                                                                                                                                                                                          +
+                +                                                                                                                                                                                          +
+                +                                                                                                                                                                                          +
+                +                                                                                                                                                                                          +
+                +                                                                                                                                                                                          +
+                +                                                                                                                                                                                          +
+                +                                                                                                                                                                                          +
+                +                                                                                                                                                                                          +
+                +                                                                                                                                                                                          +
+                +                                                                                                                                                                                          +
+                +                                                                                                                                                                                          +
+                +                                                                                                                                                                                          +
+                +                                                                                                                                                                                          +
+                +                                                                                                                                                                                          +
+                +                                                                                                                                                                                          +
+                +                                                                                                                                                                                          +
+                +                                                                                                                                                                                          +
+                +                                                                                                                                                                                          +
+                +                                                                                                                                                                                          +
+                +                                                                                                                                                                                          +
+                +++++++++++++++++++++++++++++++++++++++++++++++++++++++++++++++++++++++++++++++++++++++++++++++++++++++++++++++++++++++++++++++++++++++++++++++++++++++++++++++++++++++++++  ##  ##  ##  ##+
+                                                                                                                                                                                           ##  ##  ##  ##  +
+                                                                                                                                                                                             ##  ##  ##  ##+
+                                                                                                                                                                                           ##  ##  ##  ##  +
+                                                                                                                                                                                             ##  ##  ##  ##+
+                                                                                                                                                                                           ##  ##  ##  ##  +
+                                                                                                                                                                                             ##  ##  ##  ##+
+++++++++++++++++++++++++++++++++++++++++++++++++++++++++++++++++++++++++++++++++++++++++++++++++++++++++++++++++++++++++++++++++++++++++++++++++++++++++++++++++++++++++++++++++++++++++++++++++++++++++++++