+++++++++++++++++++++++++++++++++++++++++++++++++++++++++++++++++++++++++++++++++++++++++++++++++++++++++++++++++++++++++++++++++++++++++++++++++++++++++++++++++++++++++++++++++++++++++++++++++++++++++++++
+                                                                                                                                                                                                           +
+                                                                                                                                                                                                           +
+                                                                                                                                                                                                           +
+                                                                                                                                                                                                           +
+                                                                                                                                                                                                           +
+                                                                                                                                                                                                           +
+                                                                                                                                                                                                           +
++++++++++++++++++                                                                                                                                                                                          +
+                                                                                                                                                                                                           +
+                                                                                                                                                                                                           +
+                                                                                                                                                                                                           +
+                                                                                                                                                                                                           +
+                                                                                                                                                                                                           +
+                                                                                                                                                                                                           +
+                                                                                                                                                                                                           +
+                                                                                                                                                                                                           +
+                                                                                                                                                                                                           +
+                                                                                                                                                                                                           +
+                                                                                                                                                                                                           +
+                                                                                                                                                                                                           +
+                                                                                                                                                                                                           +
+                                                                                                                                                                                                           +
+                                                                                                                                                                                                           +
+                                                                                                                                                                                                           +
+                                                                                                                                                                                                           +
+                                                                                                                                                                                                           +
+                                                                                                                                                                                                           +
+                                                                                                                                                                                                           +
+                                                                                                                                                                                                           +
+                                                                                                                                                                                                           +
+                                                                                                                                                                                                           +
+                                                                                                                                                                                                           +
+                                                                                                                                                                                                           +
+                                                                                                                                                                                                           +
+                                                                                                                                                                                                           +
+                                                                                                                                                                                                           +
+                                                                                                                                                                                                           +
+                                                                                                                                                                                                           +
+                                                                                                                                                                                                           +
+                                                                                                                                                                                                           +
+                                                                                                                                                                                                           +
+                                                                                                                                                                                                           +
+                                                                                                                                                                                                           +
+                                                                                                                                                                                                           +
+                                                                                                                                                                                                           +
+                                                                                                                                                                                                           +
+                                                                                                                                                                                             ##  ##  ##  ##+
+                                                                                                                                                                                           ##  ##  ##  ##  +
+                                                                                                                                                                                             ##  ##  ##  ##+
+                                                                                                                                                                                           ##  ##  ##  ##  +
+                                                                                                                                                                                             ##  ##  ##  ##+
+                                                                                                                                                                                           ##  ##  ##  ##  +
+                                                                                                                                                                                             ##  ##  ##  ##+
+++++++++++++++++++++++++++++++++++++++++++++++++++++++++++++++++++++++++++++++++++++++++++++++++++++++++++++++++++++++++++++++++++++++++++++++++++++++++++++++++++++++++++++++++++++++++++++++++++++++++++++