------------------------------------------------------
|                                                    |
|                                                    |
|                                                    |
|                                                    |
|                                                    |
|                                                    |
|                                                    |
|             -----------                            |
|             |#########|                            |
|             |#########|                            |
|              #########|                            |
|              #########|                            |
|             |#########|                            |
|             |#########|                            |
|             -----------                            |
|                                                    |
|                                                    |
|                                                    |
|                                                    |
|                                                    |
|                                                    |
|                                                    |
|                                                    |
|                                                    |
|                                                    |
------------------------------------------------------