
****************************************************************************************************
* 						*					*		*								*		*	   *
* 	  	 				*					*		*								*		*	   *
* 	    *********		*					*		*								*		*	   *
* 	    *		*		*********************		*********************************		********
* 	    *		*																				   *
* 	    *		*																				   *
* 	    *		*********************************************************************		********
* 	    *																			*		*	   *
* 	    *																			*		*	   *
* 	    *																			*		*	   *
* 	  	*************************************************************				*		*	   *
* 																	*				*		*	   *
* 																	*				*		*	   *
* 						      ***********	  ***************		*				*		*	   *
*****************			  *			*	  *				*		*				*		*	   *
*				*			  *			*	  *				*		*				*		*	   *
* 			    *			  *		*****     *****			*		*	*************		********
* 			    *			  *		*		      *			*		*	*						   *
* 			    *		*******		*			  *			*		*	*						   *
* 			    *		*			*			  *			*		*****						   *
* 		*	    *		*			***************			*					************  	   *
* 		*	    *		*									*					*		   *	   *
* 		*	    *		*									*********************		   *	   *
* 		*		*		*		*************************								   *	   *
* 		*		*		*		*						*	*********************		   * 	   *
* 		*		*		*		*						*	*					*		   * 	   *
* 		*		*		*		*		*********		*	*					*		   *	   *
* 		*				*		*		*		*		*	********	 ********		   *	   *
* 		*				*		*		*		*		*		   *	 *				   *	   *
* 		*				*		*		*		*		*		   *	 * 				   *	   *
* 		*************************		*********		*********  *	 *			********	   *
* 																*  *	 *			*			   *
* 																*  *	 *			*			   *
* 		*********************************************************  *	 * 			********	   *
* 		* 														   *	 * 				   *	   *
* 		************************************************************	 *******************	   *
* 																								   *
* 																								   *
****************************************************************************************************