+++++++++++++++++++++++++++++++++++++++++++++++++++++++++++++++++++++++++++++++++++++++++++++++++++++++++++++++++++++++++++++++++++++++++++++++++++++++++++++++++++++++++++++++++++++++++++++++++++++++++++++
*                                            +             ____              __        __   _                  +                                 __       __              __      ______ _        __     __ +
+                                            +            /  _/_____ ____   / /____ _ / /_ (_)____   ____      +                                 | |     / /____   _____ / /__   / ____/(_)___   / /____/ / +
+                                            +            / / / ___// __ \ / // __ `// __// // __ \ / __ \     +                                 | | /| / // __ \ / ___// //_/  / /_   / // _ \ / // __  /  +
+                                            +          _/ / (__  )/ /_/ // // /_/ // /_ / // /_/ // / / /     +                                 | |/ // /_/ // /  /     ,<    / __/  / //  __// // /_/ /   +
+                                            +         /___//____/ \____//_/ \__,_/ \__//_/ \____//_/ /_/      +                                 |__/|__/ \____//_/   /_/|_|  /_/    /_/ \___//_/ \__,_/    +
+                                            +                                                                 +                                                                                            +
+                                            +                                                                 +                                                                                            +
+                                            +                                                                 +                                               **          *************                    +
+                                            +                                                                 +                                               **          *************                    +
+                                            +                                                                 +                                               **          **                               +
+                                            +                                                                 +                                               **          **                               +
+                                            +                                                                 +                                               **          ++                               +
+                                            +                                                                 +                                               *************************                    +
+                                            +                                                                 +                                               +++++++++++++++++++++++++                    +
+                                            +                                                                 +                                                           **         **                    +
+                                            ++++++++++++++++++++++++++                    +++++++++++++++++++++                                                           **         **                    +
+                                                                                                                                                                          **         **                    +
+                                                                                                                                                              **************         **                    +
+                                                                                                                                                              **************         **                    +
+                                                                                                                                                                                                           +
+                                                                                                                                                                                                           +
+                                                                                                                                                                                                           +
+                                                                                                                                                                                                           +
+                                                                                                                                                                                                           +
+                                                                                                                                                                                                           +
+                                                                                                                                                                                                           +
+                                                                                                                                                                                                           +
+                                                                                                                                                                                                           +
+                                                                                                                                                                                                           +
+                                                                                                                                                                                                           +
+                                                                                                                                                              ++++++++++++++++++++++++++++++++++++++++++++++
+                                                                                                                                                              +           ____   ____ ____ _               +
+                                                                                                                                                              +          / __ \ / __// __/(_)_____ ___     +
+                                                                                                                                                              +         / / / // /_ / /_ / // ___// _ \    +
+                                                                                                                                                              +        / /_/ // __// __// // /__ /  __/    +
+                                                                                                                                                              +        \____//_/  /_/  /_/ \___/ \___/     +
++++++++++++++++++++++++++++++++++++++++++++                                                                                                                   +                                            +
+         ____          __   __            +                                                                                                                   +                                            +
+        / __ ) ____ _ / /_ / /_           +                                                                                                                   +                                            +
+       / __  |/ __ `// __// __ \          +                                                                                                                   +                                            +
+      / /_/ // /_/ // /_ / / / /          +                                                                                                                   +                                            +
+     /_____/ \__,_/ \__//_/ /_/           +                                                                                                                   +                                            +
+                                          +                                                                                                                   +                                            +
+                                          +                                                                                                                   +                                            +
+                                          +                                                                                                                   +                                            +
+                                          +                                                                                                                   +                                            +
+                                          +                                                                                                                   +                                            +
+                                          +                                                                                                                                                                +
+                                                                                                                                                                                                           +
+                                                                                                                                                                                                           +
+                                                                                                                                                                                                           +
+                                                                                                                                                                                                           +
+                                                                                                                                                                                                           +
+++++++++++++++++++++++++++++++++++++++++++++++++++++++++++++++++++++++++++++++++++++++++++++++++++++++++++++++++++++++++++++++++++++++++++++++++++++++++++++++++++++++++++++++++++++++++++++++++++++++++++++